00000000000
01111111110
01111111110
01111111110
01111111120
01111111110
01111111110
01111111110
01111111110
01111111110
00000000000
