00000000000
01111111110
01111111110
01111111110
03111111112
01111111110
01111111110
01111111110
01111111110
01111111110
00000000000
